11111111111111111111111111111111111
10100000000000000C000P0000E00000001
11111111111111111101111111111111111
11111111111111111111111111111111111
